10
1,1
1111111111
1000000001
1002000e01
1000000001
1000003001
1000000001
100x000001
1000000x01
1000000001
1111111111