10
1,1
1111111111
1000110001
1000005001
1111000001
1010013001
1000010001
1004000001
1001100401
1020000001
1111111111