10
1,1
1111111111
1000110001
100000e001
1111000001
1010013001
1000010001
100x000001
1001100x01
1020000001
1111111111